6   10

TE  TO  TE  TE  TE  TE  TE  TE  TE  TE
TE  TE  TO  TE  TE  TE  TE  TE  TE  TE
TE  TE  TE  TO  TE  TE  TE  TE  TE  TE
TE  TE  TE  TE  TE  TE  TE  TE  TE  TE
TE  TE  TE  TE  TE  TE  TE  TE  TE  TE
TE  TE  TE  TE  TE  TE  TE  TE  TE  TE